carceri;regione;previsti;posti non disp;effettivi;locali;locali non disp;docce;sanitari;previsti reali;differenza tra posti previsti reali e posti effettivi;sovraffollamento;spazio primo det;spazio altri det;spazio totale;spazio tot docce;spazio  tot sanitari;numero persone per stanza;numero letti a castello;totale letti a castello;spazio tot letti a castello;spazio totale libero teorico;spazio libero singolo locale;spazio totale libero effettivo;spazio reale per persone reali;spazio previsto per persone teoriche;differenza percentuale di spazio per persona
Vasto;Abruzzo;197;50;100;98;28;15;85;147;-47;68,03%;882;495;1377;7,35;25,5;2;1;98;123,48;1220,67;12,45581633;871,9071429;8,719071429;5,931341108;68,03%
Avezzano;Abruzzo;53;2;78;33;2;33;1;51;27;152,94%;297;100;397;16,17;0,3;3;2;66;83,16;297,37;9,011212121;279,3475758;3,581379176;5,270708977;147,17%
Chieti;Abruzzo;79;0;133;33;0;33;6;79;54;168,35%;297;230;527;16,17;1,8;5;3;99;124,74;384,29;11,64515152;384,29;2,889398496;4,86443038;168,35%
L'Aquila;Abruzzo;228;6;169;216;2;12;43;222;-53;76,13%;1944;60;2004;5,88;12,9;1;1;216;272,16;1713,06;7,930833333;1697,198333;10,04259369;7,443852339;74,12%
Lanciano;Abruzzo;223;0;254;192;0;10;32;223;31;113,90%;1728;155;1883;4,9;9,6;2;1;192;241,92;1626,58;8,471770833;1626,58;6,403858268;7,294080717;113,90%
Pescara;Abruzzo;276;4;459;110;2;105;15;272;187;168,75%;990;830;1820;51,45;4,5;5;3;330;415,8;1348,25;12,25681818;1323,736364;2,883957219;4,796146245;166,30%
Sulmona;Abruzzo;232;0;442;299;2;15;290;232;210;190,52%;2691;-335;2356;7,35;87;2;1;299;376,74;1884,91;6,304046823;1872,301906;4,235977164;8,070266838;190,52%
Teramo;Abruzzo;255;1;390;239;1;11;26;254;136;153,54%;2151;80;2231;5,39;7,8;2;1;239;301,14;1916,67;8,019539749;1908,65046;4,893975539;7,484903766;152,94%
Matera;Basilicata;132;7;186;49;3;49;49;125;61;148,80%;441;415;856;24,01;14,7;4;2;98;123,48;693,81;14,15938776;651,3318367;3,501784068;4,934332096;140,91%
Melfi;Basilicata;126;0;185;122;0;14;109;126;59;146,83%;1098;20;1118;6,86;32,7;2;1;122;153,72;924,72;7,579672131;924,72;4,998486486;7,339047619;146,83%
Potenza;Basilicata;110;58;93;88;38;49;10;52;41;178,85%;792;110;902;24,01;3;2;1;88;110,88;764,11;8,683068182;434,1534091;4,668316227;3,946849174;84,55%
Catsrovillari;Calabria;122;1;174;120;1;2;20;121;53;143,80%;1080;10;1090;0,98;6;2;1;120;151,2;931,82;7,765166667;924,0548333;5,310659962;7,574219945;142,62%
Catanzaro;Calabria;682;58;648;392;32;208;23;624;24;103,85%;3528;1450;4978;101,92;6,9;2;1;392;493,92;4375,26;11,16137755;4018,095918;6,200765306;5,891636244;95,01%
Cosenza;Calabria;220;12;269;93;8;91;84;208;61;129,33%;837;635;1472;44,59;25,2;3;2;186;234,36;1167,85;12,55752688;1067,389785;3,967991766;4,85177175;122,27%
Crotone;Calabria;99;8;123;33;2;33;0;91;32;135,16%;297;330;627;16,17;0;4;2;66;83,16;527,67;15,99;495,69;4,03;5,006969697;124,24%
Laureana di Borrello;Calabria;37;0;53;37;0;37;37;37;16;143,24%;333;0;333;18,13;11,1;2;1;37;46,62;257,15;6,95;257,15;4,851886792;6,95;143,24%
Locri;Calabria;86;0;129;40;0;40;0;86;43;150,00%;360;230;590;19,6;0;4;2;80;100,8;469,6;11,74;469,6;3,640310078;5,460465116;150,00%
Palmi;Calabria;141;0;176;54;0;37;0;141;35;124,82%;486;435;921;18,13;0;4;2;108;136,08;766,79;14,19981481;766,79;4,356761364;5,43822695;124,82%
Paola;Calabria;181;27;178;161;12;156;3;154;24;115,58%;1449;100;1549;76,44;0,9;2;1;161;202,86;1268,8;7,880745342;1174,231056;6,596803685;6,487464397;98,34%
Reggio Calabria;Calabria;180;8;205;85;6;81;14;172;33;119,19%;765;475;1240;39,69;4,2;3;2;170;214,2;981,91;11,55188235;912,5987059;4,451701004;5,06999281;113,89%
Reggio Calabria Arghillà;Calabria;294;1;336;85;1;85;0;293;43;114,68%;765;1045;1810;41,65;0;4;2;170;214,2;1554,15;18,28411765;1535,865882;4,571029412;5,224033613;114,29%
Rossano;Calabria;263;0;308;142;0;136;46;263;45;117,11%;1278;605;1883;66,64;13,8;3;2;284;357,84;1444,72;10,17408451;1444,72;4,690649351;5,493231939;117,11%
Vibo Valentia;Calabria;406;8;398;154;6;121;8;398;0;100,00%;1386;1260;2646;59,29;2,4;3;2;308;388,08;2196,23;14,26123377;2110,662597;5,303172355;5,198676348;98,03%
Ariano Irpino;Campania;263;16;324;133;9;121;64;247;77;131,17%;1197;650;1847;59,29;19,2;3;2;266;335,16;1433,35;10,77706767;1336,356391;4,124556762;5,081203008;123,19%
Arienzo;Campania;58;0;84;53;0;53;53;58;26;144,83%;477;25;502;25,97;15,9;2;1;53;66,78;393,35;7,421698113;393,35;4,682738095;6,781896552;144,83%
Avellino;Campania;500;24;521;211;12;187;61;476;45;109,45%;1899;1445;3344;91,63;18,3;3;2;422;531,72;2702,35;12,80734597;2548,661848;4,891865352;5,097323697;104,20%
Aversa;Campania;254;20;263;90;6;85;65;234;29;112,39%;810;820;1630;41,65;19,5;3;2;180;226,8;1342,05;14,91166667;1252,58;4,762661597;4,931417323;103,54%
Benevento;Campania;259;7;401;230;5;230;0;252;149;159,13%;2070;145;2215;112,7;0;2;1;230;289,8;1812,5;7,880434783;1773,097826;4,421690339;6,845937552;154,83%
Carinola;Campania;562;28;487;280;26;140;139;534;-47;91,20%;2520;1410;3930;68,6;41,7;2;1;280;352,8;3466,9;12,38178571;3144,973571;6,457851276;5,596038383;86,65%
Eboli;Campania;54;0;48;9;0;9;9;54;-6;88,89%;81;225;306;4,41;2,7;6;3;27;34,02;264,87;29,43;264,87;5,518125;4,905;88,89%
Lauro;Campania;50;0;5;20;0;20;20;50;-45;10,00%;180;150;330;9,8;6;1;1;20;25,2;289;14,45;289;57,8;5,78;10,00%
Napoli Poggioreale;Campania;1624;266;2136;598;113;348;142;1358;778;157,29%;5382;5130;10512;170,52;42,6;4;2;1196;1506,96;8791,92;14,70220736;7130,570569;3,338282101;4,390745424;131,53%
Napoli Secondigliano;Campania;1142;13;1488;844;13;251;243;1129;359;131,80%;7596;1490;9086;122,99;72,9;2;1;844;1063,44;7826,67;9,273305687;7706,117026;5,178842087;6,747913333;130,30%
Pozzuoli;Campania;98;98;0;29;29;29;29;0;0;#DIV/0!;261;345;606;14,21;8,7;0;0;0;0;583,09;20,10655172;0;0;0;0
Salerno;Campania;376;0;598;130;0;70;86;376;222;159,04%;1170;1230;2400;34,3;25,8;5;3;390;491,4;1848,5;14,21923077;1848,5;3,091137124;4,916223404;159,04%
Sant'Angelo dei Lombardi;Campania;124;7;179;86;3;82;0;117;62;152,99%;774;190;964;40,18;0;3;2;172;216,72;707,1;8,222093023;682,4337209;3,812478888;5,503497749;144,35%
Santa Maria Capua Vetere;Campania;818;125;977;404;65;339;295;693;284;140,98%;3636;2070;5706;166,11;88,5;3;2;808;1018,08;4433,31;10,9735396;3720,029926;3,807604837;4,547713846;119,44%
Vallo della Lucania;Campania;40;0;57;10;0;9;9;40;17;142,50%;90;150;240;4,41;2,7;6;3;30;37,8;195,09;19,509;195,09;3,422631579;4,87725;142,50%
Bologna;Emilia-Romagna;503;23;842;446;8;130;58;480;362;175,42%;4014;285;4299;63,7;17,4;2;1;446;561,96;3655,94;8,197174888;3590,362601;4,2640886;7,137897815;167,40%
Castelfranco Emilia;Emilia-Romagna;191;42;104;57;12;45;34;149;-45;69,80%;513;670;1183;22,05;10,2;2;1;57;71,82;1078,93;18,92859649;851,7868421;8,190258097;4,459616974;54,45%
Ferrara;Emilia-Romagna;244;0;394;234;0;37;197;244;150;161,48%;2106;50;2156;18,13;59,1;2;1;234;294,84;1783,93;7,623632479;1783,93;4,527741117;7,311188525;161,48%
Forlì;Emilia-Romagna;144;12;160;123;8;0;44;132;28;121,21%;1107;105;1212;0;13,2;2;1;123;154,98;1043,82;8,486341463;975,9292683;6,099557927;6,777286585;111,11%
Modena;Emilia-Romagna;372;3;568;264;1;204;15;369;199;153,93%;2376;540;2916;99,96;4,5;3;2;528;665,28;2146,26;8,129772727;2138,130227;3,76431378;5,747661901;152,69%
Parma;Emilia-Romagna;655;35;719;515;35;443;145;620;99;115,97%;4635;700;5335;217,07;43,5;2;1;515;648,9;4425,53;8,593262136;4124,765825;5,736809215;6,297352405;109,77%
Piacenza;Emilia-Romagna;416;12;513;275;6;77;9;404;109;126,98%;2475;705;3180;37,73;2,7;2;1;275;346,5;2793,07;10,15661818;2732,130291;5,325790041;6,567620892;123,32%
Ravenna;Emilia-Romagna;49;0;92;49;0;0;0;49;43;187,76%;441;0;441;0;0;2;1;49;61,74;379,26;7,74;379,26;4,122391304;7,74;187,76%
Reggio Emilia;Emilia-Romagna;292;59;281;265;59;27;264;233;48;120,60%;2385;135;2520;13,23;79,2;2;1;265;333,9;2093,67;7,900641509;1627,532151;5,791929363;5,573740243;96,23%
Rimini;Emilia-Romagna;118;0;154;53;0;33;36;118;36;130,51%;477;325;802;16,17;10,8;3;2;106;133,56;641,47;12,10320755;641,47;4,16538961;5,436186441;130,51%
Gorizia;Friuli Venezia Giulia;53;0;72;17;0;17;16;53;19;135,85%;153;180;333;8,33;4,8;5;3;51;64,26;255,61;15,03588235;255,61;3,550138889;4,822830189;135,85%
Pordenone;Friuli Venezia Giulia;37;0;48;14;0;4;0;37;11;129,73%;126;115;241;1,96;0;4;2;28;35,28;203,76;14,55428571;203,76;4,245;5,507027027;129,73%
Tolmezzo;Friuli Venezia Giulia;149;1;142;149;1;2;149;148;-6;95,95%;1341;0;1341;0,98;44,7;1;1;149;187,74;1107,58;7,433422819;1100,146577;7,747511107;7,383534075;95,30%
Trieste;Friuli Venezia Giulia;150;4;251;64;4;5;39;146;105;171,92%;576;430;1006;2,45;11,7;4;2;128;161,28;830,57;12,97765625;778,659375;3,102228586;5,1910625;167,33%
Udine;Friuli Venezia Giulia;95;4;176;62;1;60;60;91;85;193,41%;558;165;723;29,4;18;3;2;124;156,24;519,36;8,376774194;510,9832258;2,903313783;5,378770798;185,26%
Cassino;Lazio;200;73;215;118;70;22;108;127;88;169,29%;1062;410;1472;10,78;32,4;2;1;118;148,68;1280,14;10,84864407;520,7349153;2,422022862;2,603674576;107,50%
Civitavecchia, circondariale;Lazio;357;46;533;334;46;41;154;311;222;171,38%;3006;115;3121;20,09;46,2;2;1;334;420,84;2633,87;7,885838323;2271,121437;4,26101583;6,361684698;149,30%
Civitavecchia, reclusione;Lazio;144;52;87;60;16;40;50;92;-5;94,57%;540;420;960;19,6;15;2;1;60;75,6;849,8;14,16333333;623,1866667;7,163065134;4,327685185;60,42%
Frosinone;Lazio;517;53;578;334;51;84;330;464;114;124,57%;3006;915;3921;41,16;99;2;1;334;420,84;3360;10,05988024;2846,946108;4,925512297;5,506665586;111,80%
Latina;Lazio;77;0;135;65;0;65;32;77;58;175,32%;585;60;645;31,85;9,6;3;2;130;163,8;439,75;6,765384615;439,75;3,257407407;5,711038961;175,32%
Paliano;Lazio;153;1;66;57;1;46;11;152;-86;43,42%;513;480;993;22,54;3,3;2;1;57;71,82;895,34;15,7077193;879,6322807;13,32776183;5,749230593;43,14%
Rieti;Lazio;295;24;512;157;9;157;157;271;241;188,93%;1413;690;2103;76,93;47,1;4;2;314;395,64;1583,33;10,08490446;1492,56586;2,915167695;5,059545288;173,56%
Roma;Lazio;628;62;1123;323;33;150;1;566;557;198,41%;2907;1525;4432;73,5;0,3;4;2;646;813,96;3544,24;10,97287926;3182,134985;2,833601945;5,067093924;178,82%
Roma Rebibbia, nc circondariale;Lazio;1170;113;1557;624;65;108;1;1057;500;147,30%;5616;2730;8346;52,92;0,3;3;2;1248;1572,48;6720,3;10,76971154;6020,26875;3,86658237;5,145528846;133,08%
Roma Rebibbia, circondariale;Lazio;172;40;82;43;10;43;0;132;-50;62,12%;387;645;1032;21,07;0;2;1;43;54,18;956,75;22,25;734,25;8,954268293;4,268895349;47,67%
Roma Rebibbia. circondariale femm;Lazio;272;7;370;171;7;94;87;265;105;139,62%;1539;505;2044;46,06;26,1;3;2;342;430,92;1540,92;9,01122807;1477,841404;3,994165955;5,433240454;136,03%
Roma Rebibbia, reclusione;Lazio;445;149;299;381;110;61;58;296;3;101,01%;3429;320;3749;29,89;17,4;1;1;381;480,06;3221,65;8,455774278;2291,514829;7,663929195;5,149471527;67,19%
Velletri;Lazio;412;75;510;276;43;76;265;337;173;151,34%;2484;680;3164;37,24;79,5;2;1;276;347,76;2699,5;9,780797101;2278,925725;4,468481813;5,531373118;123,79%
Viterbo;Lazio;440;35;705;440;35;7;404;405;300;174,07%;3960;0;3960;3,43;121,2;2;1;440;554,4;3280,97;7,45675;3019,98375;4,283664894;6,863599432;160,23%
Alessandria, circondariale;Liguria;233;23;217;75;10;5;74;210;7;103,33%;675;790;1465;2,45;22,2;3;2;150;189;1251,35;16,68466667;1084,503333;4,997711214;4,654520744;93,13%
Alessandria, reclusione;Liguria;265;1;366;241;1;7;63;264;102;138,64%;2169;120;2289;3,43;18,9;2;1;241;303,66;1963,01;8,14526971;1954,86473;5,341160465;7,376848039;138,11%
Chiavari;Liguria;52;0;62;23;0;22;3;52;10;119,23%;207;145;352;10,78;0,9;3;2;46;57,96;282,36;12,27652174;282,36;4,554193548;5,43;119,23%
Genova Marassi;Liguria;535;0;699;213;0;128;175;535;164;130,65%;1917;1610;3527;62,72;52,5;4;2;426;536,76;2875,02;13,49774648;2875,02;4,11304721;5,373869159;130,65%
Genova Pontedecimo;Liguria;96;11;140;96;11;96;96;85;55;164,71%;864;0;864;47,04;28,8;2;1;96;120,96;667,2;6,95;590,75;4,219642857;6,153645833;145,83%
Imperia;Liguria;53;0;78;41;0;41;3;53;25;147,17%;369;60;429;20,09;0,9;2;1;41;51,66;356,35;8,691463415;356,35;4,568589744;6,723584906;147,17%
La Spezia;Liguria;151;48;128;92;48;92;6;103;25;124,27%;828;295;1123;45,08;1,8;2;1;92;115,92;960,2;10,43695652;459,226087;3,587703804;3,041232364;84,77%
Sanremo;Liguria;223;2;263;109;2;68;99;221;42;119,00%;981;570;1551;33,32;29,7;3;2;218;274,68;1213,3;11,13119266;1191,037615;4,528660132;5,340975851;117,94%
Bergamo;Lombardia;319;1;585;192;1;113;53;318;267;183,96%;1728;635;2363;55,37;15,9;4;2;384;483,84;1807,89;9,41609375;1798,473906;3,07431437;5,637849236;183,39%
Bollate;Lombardia;1267;6;1426;707;3;185;707;1261;165;113,08%;6363;2800;9163;90,65;212,1;3;2;1414;1781,64;7078,61;10,01217822;7048,573465;4,942898643;5,563199262;112,55%
Brescia Canton Monbello;Lombardia;182;0;378;100;0;91;0;182;196;207,69%;900;410;1310;44,59;0;4;2;200;252;1013,41;10,1341;1013,41;2,680978836;5,568186813;207,69%
Brescia Verziano;Lombardia;71;1;112;71;1;71;0;70;42;160,00%;639;0;639;34,79;0;2;1;71;89,46;514,75;7,25;507,5;4,53125;7,147887324;157,75%
Busto Arsizio;Lombardia;240;15;449;177;14;154;170;225;224;199,56%;1593;315;1908;75,46;51;3;2;354;446,04;1335,5;7,54519774;1229,867232;2,739125238;5,124446798;187,08%
Como;Lombardia;226;2;445;200;2;55;177;224;221;198,66%;1800;130;1930;26,95;53,1;3;2;400;504;1345,95;6,72975;1332,4905;2,994360674;5,895975664;196,90%
Cremona;Lombardia;394;10;580;252;10;68;216;384;196;151,04%;2268;710;2978;33,32;64,8;3;2;504;635,04;2244,84;8,908095238;2155,759048;3,716825944;5,471469664;147,21%
Lecco;Lombardia;53;0;85;40;0;40;0;53;32;160,38%;360;65;425;19,6;0;3;2;80;100,8;304,6;7,615;304,6;3,583529412;5,747169811;160,38%
Lodi;Lombardia;45;3;83;30;3;27;0;42;41;197,62%;270;75;345;13,23;0;3;2;60;75,6;256,17;8,539;230,553;2,777746988;5,1234;184,44%
Mantova;Lombardia;97;3;195;56;3;5;4;94;101;207,45%;504;205;709;2,45;1,2;4;2;112;141,12;564,23;10,07553571;534,0033929;2,738478938;5,505189617;201,03%
Milano San Vittore;Lombardia;702;232;1072;492;178;272;184;470;602;228,09%;4428;1050;5478;133,28;55,2;3;2;984;1239,84;4049,68;8,231056911;2584,55187;2,410962565;3,68169782;152,71%
Monza;Lombardia;411;3;715;317;3;32;273;408;307;175,25%;2853;470;3323;15,68;81,9;3;2;634;798,84;2426,58;7,654826498;2403,615521;3,361700029;5,848212945;173,97%
Novara;Lombardia;156;0;169;102;0;10;0;156;13;108,33%;918;270;1188;4,9;0;2;1;102;128,52;1054,58;10,33901961;1054,58;6,240118343;6,760128205;108,33%
Opera;Lombardia;918;19;1302;818;19;230;625;899;403;144,83%;7362;500;7862;112,7;187,5;2;1;818;1030,68;6531,12;7,984254279;6379,419169;4,899707503;6,949258354;141,83%
Pavia ;Lombardia;515;0;683;298;0;113;104;515;168;132,62%;2682;1085;3767;55,37;31,2;3;2;596;750,96;2929,47;9,830436242;2929,47;4,289121523;5,688291262;132,62%
Sondrio;Lombardia;26;0;38;20;0;3;0;26;12;146,15%;180;30;210;1,47;0;2;1;20;25,2;183,33;9,1665;183,33;4,824473684;7,051153846;146,15%
Varese;Lombardia;53;0;100;47;0;15;0;53;47;188,68%;423;30;453;7,35;0;3;2;94;118,44;327,21;6,961914894;327,21;3,2721;6,173773585;188,68%
Vigevano;Lombardia;242;24;361;236;24;0;222;218;143;165,60%;2124;30;2154;0;66,6;2;1;236;297,36;1790,04;7,584915254;1608,002034;4,454299263;6,644636504;149,17%
Voghera;Lombardia;341;0;345;190;0;84;179;341;4;101,17%;1710;755;2465;41,16;53,7;2;1;190;239,4;2130,74;11,21442105;2130,74;6,176057971;6,248504399;101,17%
Ancona Barcaglione;Marche;100;0;90;98;0;24;0;100;-10;90,00%;882;10;892;11,76;0;1;1;98;123,48;756,76;7,722040816;756,76;8,408444444;7,5676;90,00%
Ancona Montacuto;Marche;256;0;336;111;0;102;98;256;80;131,25%;999;725;1724;49,98;29,4;4;2;222;279,72;1364,9;12,2963964;1364,9;4,062202381;5,331640625;131,25%
Ascoli Piceno;Marche;103;4;127;65;3;19;59;99;28;128,28%;585;190;775;9,31;17,7;2;1;65;81,9;666,09;10,24753846;635,3473846;5,002735312;6,16842121;123,30%
Fermo;Marche;43;0;60;22;0;0;22;43;17;139,53%;198;105;303;0;6,6;3;2;44;55,44;240,96;10,95272727;240,96;4,016;5,60372093;139,53%
Fossombrone;Marche;182;81;88;123;81;42;0;101;-13;87,13%;1107;295;1402;20,58;0;1;1;123;154,98;1226,44;9,971056911;418,7843902;4,758913525;2,301013133;48,35%
Pesaro;Marche;153;1;254;124;1;4;12;152;102;167,11%;1116;145;1261;1,96;3,6;3;2;248;312,48;942,96;7,604516129;935,3554839;3,682501905;6,113434535;166,01%
Campobasso;Molise;106;10;173;73;7;45;60;96;77;180,21%;657;165;822;22,05;18;3;2;146;183,96;597,99;8,191643836;540,6484932;3,125135799;5,100457483;163,21%
Isernia;Molise;50;0;64;28;0;8;28;50;14;128,00%;252;110;362;3,92;8,4;3;2;56;70,56;279,12;9,968571429;279,12;4,36125;5,5824;128,00%
Larino;Molise;119;25;130;106;25;53;0;94;36;138,30%;954;65;1019;25,97;0;2;1;106;133,56;859,47;8,108207547;656,7648113;5,05203701;5,519032028;109,24%
Alba;Piemonte;138;89;40;112;86;22;112;49;-9;81,63%;1008;130;1138;10,78;33,6;1;1;112;141,12;952,5;8,504464286;221,1160714;5,527901786;1,602290373;28,99%
Asti;Piemonte;205;1;244;190;1;0;190;204;40;119,61%;1710;75;1785;0;57;2;1;190;239,4;1488,6;7,834736842;1480,765263;6,068710095;7,223245186;119,02%
Biella;Piemonte;394;4;463;258;2;70;195;390;73;118,72%;2322;680;3002;34,3;58,5;2;1;258;325,08;2584,12;10,01596899;2564,088062;5,537987175;6,507837721;117,51%
Cuneo;Piemonte;433;52;402;218;48;191;1;381;21;105,51%;1962;1075;3037;93,59;0,3;2;1;218;274,68;2668,43;12,24050459;2080,88578;5,176332786;4,805740831;92,84%
Fossano;Piemonte;136;0;112;48;0;38;3;136;-24;82,35%;432;440;872;18,62;0,9;3;2;96;120,96;731,52;15,24;731,52;6,531428571;5,378823529;82,35%
Ivrea;Piemonte;195;7;260;189;7;0;0;188;72;138,30%;1701;30;1731;0;0;2;1;189;238,14;1492,86;7,898730159;1437,568889;5,529111111;7,372148148;133,33%
Saluzzo;Piemonte;424;0;356;275;0;66;204;424;-68;83,96%;2475;745;3220;32,34;61,2;2;1;275;346,5;2779,96;10,10894545;2779,96;7,808876404;6,556509434;83,96%
Torino;Piemonte;1117;24;1439;936;24;14;90;1093;346;131,66%;8424;905;9329;6,86;27;2;1;936;1179,36;8115,78;8,670705128;7907,683077;5,495262736;7,079393981;128,83%
Verbania;Piemonte;53;0;81;37;0;34;5;53;28;152,83%;333;80;413;16,66;1,5;3;2;74;93,24;301,6;8,151351351;301,6;3,72345679;5,690566038;152,83%
Vercelli;Piemonte;230;43;315;193;34;14;19;187;128;168,45%;1737;185;1922;6,86;5,7;2;1;193;243,18;1666,26;8,633471503;1372,721969;4,35784752;5,968356387;136,96%
Altamura;Puglia;52;1;82;51;1;1;51;51;31;160,78%;459;5;464;0,49;15,3;2;1;51;64,26;383,95;7,528431373;376,4215686;4,590506934;7,23887632;157,69%
Bari;Puglia;294;42;422;165;30;142;76;252;170;167,46%;1485;645;2130;69,58;22,8;3;2;330;415,8;1621,82;9,829212121;1326,943636;3,1444162;4,513413729;143,54%
Brindisi;Puglia;152;33;195;72;11;62;26;119;76;163,87%;648;400;1048;30,38;7,8;3;2;144;181,44;828,38;11,50527778;701,8219444;3,599086895;4,617249635;128,29%
Foggia;Puglia;364;19;717;213;9;71;13;345;372;207,83%;1917;755;2672;34,79;3,9;4;2;426;536,76;2096,55;9,842957746;2007,96338;2,800506807;5,516382913;196,98%
Lecce;Puglia;798;57;1195;654;54;81;264;741;454;161,27%;5886;720;6606;39,69;79,2;2;1;654;824,04;5663,07;8,65912844;5195,477064;4,347679552;6,510622887;149,75%
Lucera;Puglia;135;0;164;81;0;0;0;135;29;121,48%;729;270;999;0;0;3;2;162;204,12;794,88;9,813333333;794,88;4,846829268;5,888;121,48%
San Severo;Puglia;61;0;80;138;0;0;0;61;19;131,15%;1242;-385;857;0;0;1;1;138;173,88;683,12;4,950144928;683,12;8,539;11,19868852;131,15%
Taranto;Puglia;500;16;936;349;16;135;96;484;452;193,39%;3141;755;3896;66,15;28,8;3;2;698;879,48;2921,57;8,371260745;2787,629828;2,978236996;5,575259656;187,20%
Trani, circondariale;Puglia;447;146;396;202;88;114;94;301;95;131,56%;1818;1225;3043;55,86;28,2;2;1;202;254,52;2704,42;13,38821782;1526,256832;3,854183918;3,414444814;88,59%
Trani, reclusione femminile;Puglia;32;0;40;19;0;0;19;32;8;125,00%;171;65;236;0;5,7;3;2;38;47,88;182,42;9,601052632;182,42;4,5605;5,700625;125,00%
Turi;Puglia;108;0;161;42;0;3;1;108;53;149,07%;378;330;708;1,47;0,3;4;2;84;105,84;600,39;14,295;600,39;3,729130435;5,559166667;149,07%
Alghero;Sardegna;156;0;86;62;0;62;0;156;-70;55,13%;558;470;1028;30,38;0;2;1;62;78,12;919,5;14,83064516;919,5;10,69186047;5,894230769;55,13%
Arbus id Arenas;Sardegna;176;50;89;40;10;40;0;126;-37;70,63%;360;680;1040;19,6;0;3;2;80;100,8;919,6;22,99;689,7;7,749438202;3,91875;50,57%
Cagliari;Sardegna;561;0;763;282;0;278;22;561;202;136,01%;2538;1395;3933;136,22;6,6;3;2;564;710,64;3079,54;10,92035461;3079,54;4,036094364;5,489376114;136,01%
Isili;Sardegna;130;23;78;30;4;30;11;107;-29;72,90%;270;500;770;14,7;3,3;3;2;60;75,6;676,4;22,54666667;586,2133333;7,515555556;4,509333333;60,00%
Lanusei;Sardegna;33;0;30;14;0;14;0;33;-3;90,91%;126;95;221;6,86;0;3;2;28;35,28;178,86;12,77571429;178,86;5,962;5,42;90,91%
Nuoro;Sardegna;378;107;191;154;60;101;55;271;-80;70,48%;1386;1120;2506;49,49;16,5;2;1;154;194,04;2245,97;14,58422078;1370,916753;7,177574624;3,626763897;50,53%
Onanì;Sardegna;292;122;113;64;23;57;2;170;-57;66,47%;576;1140;1716;27,93;0,6;2;1;64;80,64;1606,83;25,10671875;1029,375469;9,109517423;3,525258455;38,70%
Oristano;Sardegna;264;2;234;138;1;138;9;262;-28;89,31%;1242;630;1872;67,62;2,7;2;1;138;173,88;1627,8;11,79565217;1616,004348;6,906001486;6,12122859;88,64%
Sassari;Sardegna;454;1;529;292;1;292;9;453;76;116,78%;2628;810;3438;143,08;2,7;2;1;292;367,92;2924,3;10,01472603;2914,285274;5,509045887;6,419130559;116,52%
Tempio Pausania;Sardegna;170;0;167;90;0;90;18;170;-3;98,24%;810;400;1210;44,1;5,4;2;1;90;113,4;1047,1;11,63444444;1047,1;6,27005988;6,159411765;98,24%
Agrigento;Sicilia;283;20;385;247;18;192;42;263;122;146,39%;2223;180;2403;94,08;12,6;2;1;247;311,22;1985,1;8,036842105;1840,436842;4,780355434;6,503310396;136,04%
Augusta;Sicilia;364;22;560;339;22;75;0;342;218;163,74%;3051;125;3176;36,75;0;2;1;339;427,14;2712,11;8,000324484;2536,102861;4,52875511;6,967315553;153,85%
Barcellona Pozzo di Gotto;Sicilia;387;78;204;128;39;84;72;309;-105;66,02%;1152;1295;2447;41,16;21,6;2;1;128;161,28;2222,96;17,366875;1545,651875;7,576724877;3,993932494;52,71%
Caltagirone;Sicilia;541;164;428;215;70;186;70;377;51;113,53%;1935;1630;3565;91,14;21;2;1;215;270,9;3181,96;14,79981395;2145,973023;5,013955662;3,966678416;79,11%
Caltanisetta;Sicilia;183;0;229;111;0;108;103;183;46;125,14%;999;360;1359;52,92;30,9;3;2;222;279,72;995,46;8,968108108;995,46;4,3469869;5,439672131;125,14%
Castelvetrano;Sicilia;44;0;71;40;0;25;0;44;27;161,36%;360;20;380;12,25;0;2;1;40;50,4;317,35;7,93375;317,35;4,46971831;7,2125;161,36%
Catania Bicocca;Sicilia;136;5;179;127;5;123;0;131;48;136,64%;1143;45;1188;60,27;0;2;1;127;160,02;967,71;7,61976378;929,6111811;5,193358554;6,835376332;131,62%
Catania Piazza Lanza;Sicilia;279;0;414;106;0;94;35;279;135;148,39%;954;865;1819;46,06;10,5;4;2;212;267,12;1495,32;14,10679245;1495,32;3,611884058;5,359569892;148,39%
Enna;Sicilia;167;12;204;79;3;39;0;155;49;131,61%;711;440;1151;19,11;0;3;2;158;199,08;932,81;11,80772152;897,3868354;4,398955076;5,373573865;122,16%
Favignana;Sicilia;89;0;89;33;0;33;0;89;0;100,00%;297;280;577;16,17;0;3;2;66;83,16;477,67;14,47484848;477,67;5,367078652;5,367078652;100,00%
Gela;Sicilia;48;0;67;48;0;48;48;48;19;139,58%;432;0;432;23,52;14,4;2;1;48;60,48;333,6;6,95;333,6;4,979104478;6,95;139,58%
Giarre;Sicilia;58;7;72;58;7;58;0;51;21;141,18%;522;0;522;28,42;0;2;1;58;73,08;420,5;7,25;369,75;5,135416667;6,375;124,14%
Messina;Sicilia;302;83;221;134;49;134;75;219;2;100,91%;1206;840;2046;65,66;22,5;2;1;134;168,84;1789;13,35074627;1134,813433;5,134902411;3,757660374;73,18%
Noto;Sicilia;176;0;145;98;0;98;0;176;-31;82,39%;882;390;1272;48,02;0;2;1;98;123,48;1100,5;11,22959184;1100,5;7,589655172;6,252840909;82,39%
Palermo, circondariale;Sicilia;1165;9;1416;735;7;298;722;1156;260;122,49%;6615;2150;8765;146,02;216,6;2;1;735;926,1;7476,28;10,17180952;7405,077333;5,229574388;6,356289557;121,55%
Palermo, reclusione;Sicilia;569;34;535;265;34;184;4;535;0;100,00%;2385;1520;3905;90,16;1,2;3;2;530;667,8;3145,84;11,87109434;2742,222792;5,125650079;4,819372219;94,02%
Piazza Armerina;Sicilia;49;1;76;42;1;31;0;48;28;158,33%;378;35;413;15,19;0;2;1;42;52,92;344,89;8,211666667;336,6783333;4,42997807;6,870986395;155,10%
Ragusa;Sicilia;196;13;201;66;9;54;3;183;18;109,84%;594;650;1244;26,46;0,9;4;2;132;166,32;1050,32;15,91393939;907,0945455;4,512908186;4,628033395;102,55%
San Cataldo;Sicilia;135;1;103;21;1;21;0;134;-31;76,87%;189;570;759;10,29;0;5;3;63;79,38;669,33;31,87285714;637,4571429;6,1889043;4,721904762;76,30%
Sciacca;Sicilia;73;53;23;25;16;24;0;20;3;115,00%;225;240;465;11,76;0;1;1;25;31,5;421,74;16,8696;151,8264;6,601147826;2,079813699;31,51%
Siracusa;Sicilia;545;0;661;245;0;219;19;545;116;121,28%;2205;1500;3705;107,31;5,7;3;2;490;617,4;2974,59;12,14118367;2974,59;4,500136157;5,457963303;121,28%
Termini Imerese;Sicilia;95;0;108;51;0;42;1;95;13;113,68%;459;220;679;20,58;0,3;3;2;102;128,52;529,6;10,38431373;529,6;4,903703704;5,574736842;113,68%
Trapani;Sicilia;555;58;539;233;32;159;72;497;42;108,45%;2097;1610;3707;77,91;21,6;3;2;466;587,16;3020,33;12,9627897;2605,52073;4,833990222;4,694631945;97,12%
Arezzo;Toscana;108;84;43;56;37;9;3;24;19;179,17%;504;260;764;4,41;0,9;1;1;56;70,56;688,13;12,28803571;233,4726786;5,429597176;2,161784061;39,81%
Firenze;Toscana;91;14;106;51;8;0;0;77;29;137,66%;459;200;659;0;0;3;2;102;128,52;530,48;10,40156863;447,267451;4,219504255;4,915026934;116,48%
Firenze Sollicciano;Toscana;497;136;534;358;102;62;29;361;173;147,92%;3222;695;3917;30,38;8,7;2;1;358;451,08;3426,84;9,572178771;2450,477765;4,588909673;4,930538763;107,44%
Grosseto;Toscana;15;0;29;9;0;1;0;15;14;193,33%;81;30;111;0,49;0;4;2;18;22,68;87,83;9,758888889;87,83;3,02862069;5,855333333;193,33%
Livorno;Toscana;391;211;246;296;179;78;83;180;66;136,67%;2664;475;3139;38,22;24,9;1;1;296;372,96;2702,92;9,131486486;1068,383919;4,343024061;2,73243969;62,92%
Livorno Gorgona;Toscana;89;0;82;55;0;55;0;89;-7;92,13%;495;170;665;26,95;0;2;1;55;69,3;568,75;10,34090909;568,75;6,93597561;6,390449438;92,13%
Lucca;Toscana;63;22;85;59;18;5;7;41;44;207,32%;531;20;551;2,45;2,1;2;1;59;74,34;472,11;8,001864407;328,0764407;3,859722832;5,20756255;134,92%
Massa;Toscana;174;8;238;109;4;108;98;166;72;143,37%;981;325;1306;52,92;29,4;3;2;218;274,68;949;8,706422018;914,1743119;3,841068538;5,253875356;136,78%
Massa Marittima;Toscana;48;0;46;24;0;24;24;48;-2;95,83%;216;120;336;11,76;7,2;2;1;24;30,24;286,8;11,95;286,8;6,234782609;5,975;95,83%
Pisa;Toscana;197;18;288;153;10;28;114;179;109;160,89%;1377;220;1597;13,72;34,2;2;1;153;192,78;1356,3;8,864705882;1267,652941;4,401572712;6,434786503;146,19%
Pistoia;Toscana;76;0;72;48;0;0;0;76;-4;94,74%;432;140;572;0;0;2;1;48;60,48;511,52;10,65666667;511,52;7,104444444;6,730526316;94,74%
Porto Azzurro;Toscana;334;13;316;306;10;118;13;321;-5;98,44%;2754;140;2894;57,82;3,9;2;1;306;385,56;2446,72;7,995816993;2366,76183;7,489752627;7,086113264;94,61%
Prato;Toscana;589;3;597;299;3;25;249;586;11;101,88%;2691;1450;4141;12,25;74,7;2;1;299;376,74;3677,31;12,29869565;3640,413913;6,09784575;6,180668783;101,36%
San Gimignano;Toscana;243;20;319;231;20;0;4;223;96;143,05%;2079;60;2139;0;1,2;2;1;231;291,06;1846,74;7,994545455;1686,849091;5,287928185;6,941765806;131,28%
Siena;Toscana;58;0;73;39;0;11;4;58;15;125,86%;351;95;446;5,39;1,2;2;1;39;49,14;390,27;10,00692308;390,27;5,346164384;6,728793103;125,86%
Volterra;Toscana;189;0;180;176;0;0;1;189;-9;95,24%;1584;65;1649;0;0,3;2;1;176;221,76;1426,94;8,107613636;1426,94;7,927444444;7,54994709;95,24%
Bolzano;Trentino-Alto Adige;88;3;117;31;2;1;0;85;32;137,65%;279;285;564;0,49;0;4;2;62;78,12;485,39;15,65774194;454,0745161;3,88097877;5,159937683;132,95%
Trento;Trentino-Alto Adige;422;4;369;170;2;170;170;418;-49;88,28%;1530;1260;2790;83,3;51;3;2;340;428,4;2227,3;13,10176471;2201,096471;5,965031086;5,215868414;87,44%
Spoleto;Umbria;546;6;459;403;6;130;1;540;-81;85,00%;3627;715;4342;63,7;0,3;2;1;403;507,78;3770,22;9,355384615;3714,087692;8,091694319;6,802358411;84,07%
Orvieto;Umbria;98;0;122;35;0;33;0;98;24;124,49%;315;315;630;16,17;0;4;2;70;88,2;525,63;15,018;525,63;4,308442623;5,363571429;124,49%
Perugia;Umbria;363;57;457;310;57;307;40;306;151;149,35%;2790;265;3055;150,43;12;2;1;310;390,6;2501,97;8,070870968;2041,930355;4,468118938;5,625152493;125,90%
Terni;Umbria;422;0;557;281;0;70;201;422;135;131,99%;2529;705;3234;34,3;60,3;2;1;281;354,06;2785,34;9,912241993;2785,34;5,000610413;6,600331754;131,99%
Brissogne;Valle d'Aosta;181;13;148;167;13;48;23;168;-20;88,10%;1503;70;1573;23,52;6,9;1;1;167;210,42;1332,16;7,977005988;1228,458922;8,300398123;6,787065868;81,77%
Belluno;Veneto;89;7;110;50;6;20;20;82;28;134,15%;450;195;645;9,8;6;3;2;100;126;503,2;10,064;442,816;4,0256;4,975460674;123,60%
Padova, circondariale;Veneto;188;4;217;68;2;68;68;184;33;117,93%;612;600;1212;33,32;20,4;4;2;136;171,36;986,92;14,51352941;957,8929412;4,414253185;5,095175219;115,43%
Padova, reclusione ;Veneto;438;63;547;386;57;48;0;375;172;145,87%;3474;260;3734;23,52;0;2;1;386;486,36;3224,12;8,352642487;2748,019378;5,023801423;6,274016845;124,89%
Rovigo;Veneto;211;6;234;113;6;109;109;205;29;114,15%;1017;490;1507;53,41;32,7;3;2;226;284,76;1136,13;10,05424779;1075,804513;4,597455185;5,098599589;110,90%
Treviso;Veneto;138;12;214;63;4;6;5;126;88;169,84%;567;375;942;2,94;1,5;4;2;126;158,76;778,8;12,36190476;729,352381;3,408188696;5,285162181;155,07%
Venezia, circondariale;Veneto;159;3;263;86;3;86;86;156;107;168,59%;774;365;1139;42,14;25,8;4;2;172;216,72;854,34;9,934186047;824,5374419;3,135123353;5,185770075;165,41%
Venezia Giudecca;Veneto;112;0;100;28;0;16;28;112;-12;89,29%;252;420;672;7,84;8,4;4;2;56;70,56;585,2;20,9;585,2;5,852;5,225;89,29%
Verona;Veneto;335;17;594;308;15;89;281;318;276;186,79%;2772;135;2907;43,61;84,3;2;1;308;388,08;2391,01;7,763019481;2274,564708;3,829233515;6,789745396;177,31%
Vicenza;Veneto;276;28;377;204;26;204;196;248;129;152,02%;1836;360;2196;99,96;58,8;2;1;204;257,04;1780,2;8,726470588;1553,311765;4,120190357;5,627941176;136,59%